00000000000000000000
00000000000000000000
00000000000000000000
00011111111111111000
00044333333333344000
00443322222222334400
00443322222222334400
00443322222222334400
00044333333333344000
00044444444444444000
00000000000000000000
00000000000000000000
00000000000000000000
8000 	#one star
10000 	#two star
12000 	#three star
10 	#limit step
0	#vertical
0	#horizontal
0	#Teffect
0	#chocolate
4	#candy type
2	#mode
0	#initcandy
0	#LastScore
1	#IsUnlock