00000000000000000000
00000000000000000000
00000000000000000000
11111111111111110000
33333333333333330000
44444444444444440000
22222222222222220000
44444444444444440000
33333333333333330000
00000000000000000000
00000000000000000000
00000000000000000000
00000000000000000000
5000 	#one star
7000 	#two star
9000 	#three star
10 	#limit step
0	#vertical
0	#horizontal
0	#Teffect
0	#chocolate
5	#candy type
1	#mode
1	#initcandy
8460	#LastScore
1	#IsUnlock