00000000000000000000
11111111111111110000
22222222222222220000
22222222222222220000
22222222222222220000
22222222222222220000
22222222222222220000
22222222222222220000
22222222222222220000
00000000000000000000
00000000000000000000
00000000000000000000
00000000000000000000
10000 	#one star
20000 	#two star
200000 	#three star
10 	#limit step
0	#vertical
0	#horizontal
0	#Teffect
0	#chocolate
5	#candy type
1	#mode
0	#initcandy
0	#LastScore
0	#IsUnlock