0	#last score history
00000000000000000000
22222222222222220000
11111111111111110000
11111111111111110000
11111111111111110000
11111111111111110000
11111111111111110000
11111111111111110000
11111111111111110000
00000000000000000000
00000000000000000000
00000000000000000000
00000000000000000000
2000 	#one star
2000 	#two star
2000 	#three star
10 	#limit step
0	#vertical
0	#horizontal
0	#Teffect
0	#chocolate
1	#mode




