00000000000000000000
11111111111111111110
11111111111111111110
11111111111111111110
11111111111111111110
11111111111111111110
11111111111111111110
11111111111111111110
11111111111111111110
11111111111111111100
11111111111111111000
11111111111111110000
00000000000000000000
