00000000000000000000
00000000000000000000
00000000000000000000
00001111111100000000
00002222222200000000
00002222222200000000
00002222222200000000
00002222222200000000
00000000000000000000
00000000000000000000
00000000000000000000
00000000000000000000
00000000000000000000
300 	#one star
400	#two star
500	#three star
6 	#max step
0	#vertical
0	#horizontal
0	#Teffect
0	#chocolate
6	#candy type
1	#mode
0	#initcandy
2160	#LastScore
1	#IsUnlock