00000000000000000000
00000222222000000000
00001111111100000000
00011111111110000000
00111111111111000000
01111111111111100000
11110000011111110000
11111000111111110000
11111101111111110000
00000000000000000000
00000000000000000000
00000000000000000000
00000000000000000000
