00000000000000000000
22222222222000000000
11111111111100000000
11111111111110000000
11111111111111000000
11111111111111100000
11111111111111110000
11111111111111110000
11111111111111110000
00000000000000000000
00000000000000000000
00000000000000000000
00000000000000000000
