11111111111111111111
11111111111111111110
11111111011111111110
11111111011111111110
11111111111111111110
11111111111111111110
11111111111111111110
11111111111111111110
11111111111111111110
11111111111111111110
11111111111111111110
11111111111111111110
00000000000000000000
