00000000000000000000
00000000000000000000
00011111111111111000
00022222222222222000
00022222222222222000
02222222222222222220
02222222222222222220
02222222222222222220
00022222222222222000
00022222222222222000
00022222222222222000
00000000000000000000
00000000000000000000
2500 	#one star
3500 	#two star
5000 	#three star
10 	#limit step
0	#vertical
0	#horizontal
0	#Teffect
0	#chocolate
5	#candy type
1	#mode
1	#initcandy
0	#LastScore
1	#IsUnlock