00000000000000000000
00000000000000000000
00000000000000000000
00011111111111111000
00022222222222222000
00222222222222222200
00222222222222222200
00222222222222222200
00022222222222222000
00022222222222222000
00000000000000000000
00000000000000000000
00000000000000000000
6000 	#one star
7000 	#two star
8500 	#three star
4 	#limit step
0	#vertical
0	#horizontal
0	#Teffect
0	#chocolate
4	#candy type
1	#mode
1	#initcandy
0	#LastScore
1	#IsUnlock