00000000000000000000
11111111111000000000
22222222222200000000
22222222222220000000
22222222222222000000
22222222222222200000
22222000022222220000
22222200222222220000
22222222222222220000
00000000000000000000
00000000000000000000
00000000000000000000
00000000000000000000
