00000000000000000000
00000000000000000000
00000000000000000000
00000011111110000000
00000022222220000000
00000222222222000000
00000222222222000000
00000222222222000000
00000222222222000000
00000222222222000000
00000022222220000000
00000022222220000000
00000000000000000000
6000 	#one star
7000 	#two star
8500 	#three star
4 	#limit step
0	#vertical
0	#horizontal
0	#Teffect
0	#chocolate
6	#candy type
1	#mode
1	#initcandy
0	#LastScore
0	#IsUnlock